┌───────┬───────┬───────┬───────┬───────┐
│ ? : ? │ ? : ? │ ? : ? │ ? : ? │ ? : ? │
├───────┼───────┼───────┼───────┼───────┤
│ ? : ? │ ? : ? │ ? : ? │ ? : ? │ ? : ? │
├───────┼───────┼───────┼───────┼───────┤
│ ? : ? │ ? : ? │ ? : ? │ ? : ? │ ? : ? │
├───────┼───────┼───────┼───────┼───────┤
│ ? : ? │ ? : ? │ ? : ? │ ? : ? │ ? : ? │
└───────┴───────┴───────┴───────┴───────┘

+-------+-------+-------+-------+-------+
| ? : ? | ? : ? | ? : ? | ? : ? | ? : ? |
+-------+-------+-------+-------+-------+
| ? : ? | ? : ? | ? : ? | ? : ? | ? : ? |
+-------+-------+-------+-------+-------+
| ? : ? | ? : ? | ? : ? | ? : ? | ? : ? |
+-------+-------+-------+-------+-------+
| ? : ? | ? : ? | ? : ? | ? : ? | ? : ? |
+-------+-------+-------+-------+-------+